11111111111111111111111
10000000000000100000001
10000000000000000000001
11011100M01111000000001
1E000000001111000000001
111111110M011100P000001
10000000000010000000011
10000000000001000000001
11011100M01111000000001
10000000000C00000000001
11111111111111111111111