111111111111111111
1000000000CM000111
1000E0000000000001
1000000C0M00000001
100000C0001100M001
111111111111111111