11111111111111111111111
10P000000110000000000E1
10000000011000000000011
100000000C000000C000001
10000000011111110000101
10000000011111110000101
100000000111111C0000101
100001111111111C0000101
10000111110000000000101
10000111110000000000101
10000C000000000000011C1
11111111111111111111111