11111111111111111111111
1CCCCCCCCCCCCCCCCCCCE11
1CCCCCCCCCCCCCCCCC11111
1CCCCCCCCCCCCCCCCCCCCC1
1CCCCCCCCCCCCCCCCCCCCC1
1CCCCCCCCCCCCCCCCCCCCC1
1CCCCCCCCCCCCCCCCCCCCC1
1CCCCCCCCCCCCCCCCCCCCC1
1CCCCCCCCCCCCCCCCCCCCC1
1CCCCCCCCCCCCCCCCCCCCC1
1PCCCCCCCCCCCCCCCCCCCC1
11111111111111111111111