11111111111111111111111
1CCCCCCCCCCCCCCCCCC1E11
1CCCCCCCCCCCCCCCCC11111
1CCCCCCCCCCCCCCCCCCCCC1
1CCCCCCCCCCCCCCCCCCCCC1
1CCCCCCCCCCCCCCCCCCCCC1
1CCCCCCCCCCCCCCCCCCCCC1
1CCCCCCCCCCCCCCCCCCCCM1
1CCCMMMMMMMMMMMMMMMCCC1
1CCMMMMMMMMMMMMMMMMMCC1
1PMMMMMMMMMMMMMMMMMMMC1
11111111111111111111111