11111111111111111111111
1000M000000000100000001
1000M000000000000000001
1111M100M01111000000001
1E00MC0C000111100000001
1111M1110M011100P000001
1000M000000010000000011
1000M000000001000000001
1101M100M01111000000001
1000M000000C00000000001
11111111111111111111111